11111111111111111111111111
1110000000000001000000E111
1000P000000000010000000111
100000000000000C0000000111
11111111111111111111111111
