11111111111111111
11101111111111111
1000P0000E0000001
10000000000C00011
11111111111111111